{
  "labyrinth": {
    "easy": [
        ["W", "W", "W", "W", "W", "W", "W", "W", "W"],
        ["W", "PL", "E", "E", "E", "E", "P", "E", "W"],
        ["W", "E", "W", "W", "E", "W", "W", "E", "W"],
        ["W", "E", "W", "E", "E", "E", "W", "E", "W"],
        ["W", "E", "E", "E", "W", "E", "E", "E", "W"],
        ["W", "W", "E", "W", "W", "W", "E", "W", "W"],
        ["W", "E", "E", "E", "P", "E", "E", "E", "W"],
        ["W", "W", "W", "W", "E", "W", "W", "X", "W"],
        ["W", "W", "W", "W", "W", "W", "W", "W", "W"]
      ]
  }
}